111111111111111111111111111111
1000C00000000C0000010000000011
1E1001010010000010100100000011
111001001010101000100100000011
11P000000000000000000010000011
111111111111111111111111111111