111111111111111111111111111111
1000000000000C0000010000000011
1E10010100100000101001000C0011
1110010010101C10001001000C0011
11P000000000000000C00010000011
111111111111111111111111111111