111111111111111111111111111111
1CCC1CCCCCCCC1CCCCC1CCCCCCCC11
1E1CC1C1CC1CCCCC1C1CC1CCCCCC11
111CC1CC1C1C1C1CCC1CC1CCCCCC11
11PCCCCCCCCCCCCCCCCCCC1CCCCC11
111111111111111111111111111111