1111111111111111111111111111111111
1000000000000000000000000000000001
1E10010100100000101001000000010101
1110010010101010001001000000010101
11P000000000000000C000000000000001
1111111111111111111111111111111111