111111111111111111111111111111
100010000000010000010000000011
1E10C1010010000010100100000011
111001001010101000100100000011
11P000000000000C00000010000011
111111111111111111111111111111