111111111111111111111111111111
100010000000010000010000000001
1E10C1010010000010100111111001
111001001010101000100100001001
11P000000000000C0000001C100001
111111111111111111111111111111